000000000
010101010
010101010
010101010
000000000
000000000
000000000
000000000
000090000
000080000