000000000
111111111
111111111
111111111
000000000
000000000
000000000
000090000
000080000